












------------------------------------------------------------
-                                                          -
-                                                          -
-                                                          -
-@                                                        E-
----r                                                   ----
------------------------------------------------------------
