












------------------------------------------------------------
-                                                          -
-                                                          -
-                                                          -
-@                                                        E-
----r                      r                            ----
------------------------------------------------------------
