












------------------------------------------------------------
-                                                          -
-                                                          -
-                                                          -
-@                                                        E-
----r         r         r         r         r           ----
------------------------------------------------------------
