












------------------------------------------------------------
-                                                          -
-                                                          -
-                                                          -
-@                                                        E-
----rrrrrrrrrrrrrrrrrrrrrrrrrrrrrrrrrrrrrrrrrrrrrrrrrrrr----
------------------------------------------------------------
