









------------------------------------------------------------
-                                                          -
-                                                          -
-                                                          -
-                                                          -
-                                                          -
-                                                          -
-@                                                        E-
------------------------------------------------------------
